AAAAAQAAAAEAAAAvAw== PowerOff
AAAAAQAAAAEAAAAlAw== Input
AAAAAQAAAAEAAAAOAw== GGuide
AAAAAgAAAKQAAABbAw== EPG
AAAAAgAAAHcAAAB2Aw== Favorites
AAAAAQAAAAEAAAA6Aw== Display
AAAAAQAAAAEAAABgAw== Home
AAAAAgAAAJcAAAA2Aw== Options
AAAAAgAAAJcAAAAjAw== Return
AAAAAQAAAAEAAAB0Aw== Up
AAAAAQAAAAEAAAB1Aw== Down
AAAAAQAAAAEAAAAzAw== Right
AAAAAQAAAAEAAAA0Aw== Left
AAAAAQAAAAEAAABlAw== Confirm
AAAAAgAAAJcAAAAlAw== Red
AAAAAgAAAJcAAAAmAw== Green
AAAAAgAAAJcAAAAnAw== Yellow
AAAAAgAAAJcAAAAkAw== Blue
AAAAAQAAAAEAAAAAAw== Num1
AAAAAQAAAAEAAAABAw== Num2
AAAAAQAAAAEAAAACAw== Num3
AAAAAQAAAAEAAAADAw== Num4
AAAAAQAAAAEAAAAEAw== Num5
AAAAAQAAAAEAAAAFAw== Num6
AAAAAQAAAAEAAAAGAw== Num7
AAAAAQAAAAEAAAAHAw== Num8
AAAAAQAAAAEAAAAIAw== Num9
AAAAAQAAAAEAAAAJAw== Num0
AAAAAQAAAAEAAAAKAw== Num11
AAAAAQAAAAEAAAALAw== Num12
AAAAAQAAAAEAAAASAw== VolumeUp
AAAAAQAAAAEAAAATAw== VolumeDown
AAAAAQAAAAEAAAAUAw== Mute
AAAAAQAAAAEAAAAQAw== ChannelUp
AAAAAQAAAAEAAAARAw== ChannelDown
AAAAAgAAAJcAAAAoAw== SubTitle
AAAAAgAAAKQAAAAQAw== ClosedCaption
AAAAAQAAAAEAAAALAw== Enter
AAAAAgAAAJcAAAAdAw== DOT
AAAAAgAAAHcAAAANAw== Analog
AAAAAQAAAAEAAAA/Aw== Teletext
AAAAAQAAAAEAAABjAw== Exit
AAAAAQAAAAEAAAA4Aw== Analog2
AAAAAgAAABoAAAA7Aw== *AD
AAAAAgAAAJcAAAAyAw== Digital
AAAAAgAAAJcAAAAuAw== Analog?
AAAAAgAAAJcAAAAsAw== BS
AAAAAgAAAJcAAAArAw== CS
AAAAAgAAAJcAAAAQAw== BSCS
AAAAAgAAAJcAAAAVAw== Ddata
AAAAAQAAAAEAAAA+Aw== PicOff
AAAAAgAAABoAAABXAw== Tv_Radio
AAAAAgAAAHcAAABgAw== Theater
AAAAAgAAABoAAAB9Aw== SEN
AAAAAgAAABoAAAB6Aw== InternetWidgets
AAAAAgAAABoAAAB5Aw== InternetVideo
AAAAAgAAABoAAAB8Aw== Netflix
AAAAAgAAABoAAAB4Aw== SceneSelect
AAAAAgAAAHcAAABNAw== Mode3D
AAAAAgAAABoAAAB7Aw== iManual
AAAAAQAAAAEAAAAXAw== Audio
AAAAAgAAAKQAAAA9Aw== Wide
AAAAAQAAAAEAAAA7Aw== Jump
AAAAAgAAAKQAAAB3Aw== PAP
AAAAAgAAAHcAAABrAw== MyEPG
AAAAAgAAAJcAAAAWAw== ProgramDescription
AAAAAgAAAHcAAABsAw== WriteChapter
AAAAAgAAABoAAAB+Aw== TrackID
AAAAAgAAAJcAAAAMAw== TenKey
AAAAAgAAABoAAABvAw== AppliCast
AAAAAgAAABoAAAByAw== acTVila
AAAAAgAAAHcAAAAfAw== DeleteVideo
AAAAAgAAABoAAABVAw== PhotoFrame
AAAAAgAAABoAAABnAw== TvPause
AAAAAgAAABoAAAB1Aw== KeyPad
AAAAAgAAAJcAAAA4Aw== Media
AAAAAgAAABoAAABYAw== SyncMenu
AAAAAgAAAJcAAAAcAw== Forward
AAAAAgAAAJcAAAAaAw== Play
AAAAAgAAAJcAAAAbAw== Rewind
AAAAAgAAAJcAAAA8Aw== Prev
AAAAAgAAAJcAAAAYAw== Stop
AAAAAgAAAJcAAAA9Aw== Next
AAAAAgAAAJcAAAAgAw== Rec
AAAAAgAAAJcAAAAZAw== Pause
AAAAAgAAAJcAAABIAw== Eject
AAAAAgAAAJcAAAB4Aw== FlashPlus
AAAAAgAAAJcAAAB5Aw== FlashMinus
AAAAAgAAABoAAABgAw== TopMenu
AAAAAgAAABoAAABhAw== PopUpMenu
AAAAAgAAAHcAAABqAw== RakurakuStart
AAAAAgAAABoAAABkAw== OneTouchTimeRec
AAAAAgAAABoAAABlAw== OneTouchView
AAAAAgAAABoAAABiAw== OneTouchRec
AAAAAgAAABoAAABjAw== OneTouchStop
AAAAAgAAABoAAABzAw== DUX
AAAAAgAAABoAAAB2Aw== FootballMode
AAAAAgAAABoAAAB0Aw== Social

